##########
#@  ######
##       #
###%###  #
###!###  #
###*    %#
########!#
##########
##########
##########
