################
#@             #
# ######### ####
# ######### ####
# ######### ####
# ######### ####
# ######### ####
#%######### ####
#!######### ####
#* !%       ####
# ######### ####
# ######### ####
# ######### ####
#           ####
################
################
