##########
#@  ######
##       #
### ###  #
###!###  #
###*     #
########!#
##########
##########
##########
