##########
#@      *#
###  #####
### !#####
##########
##########
##########
##########
##########
##########