##########
#@ #######
#  *    !#
#       !#
#       !#
# ########
# ########
# ########
# ########
##########