############
#@ #########
#       !###
#       !* #
#       !# #
# ######## #
# ######## #
#  ####### #
#          #
############
