############
#@ #########
#      %!###
#      %!* #
#      %!# #
# ######## #
# ######## #
#  ####### #
#          #
############
