################
#              #
####### ###### #
#######@###### #
#######%###### #
###### !### !% #
#      %   *## #
# #####!### ## #
#     #%    !% #
#### ## ###!## #
#    ## ###%## #
# ##### ### ## #
#              #
################
################
################
