################
#@             #
## ########### #
## ########### #
##    ######## #
##### ########%#
#     ########!#
# #######       #
# ####### #### #
#     ###   ## #
##### ##### ## #
#     ##    ## #
# ###### ##### #
#           %!*#
################